//MAP CONVERTED BY dmm2tgm.py THIS HEADER COMMENT PREVENTS RECONVERSION, DO NOT REMOVE
"a" = (
/mob/living/simple_animal/hostile/ordeal/steel_dawn/steel_noon,
/turf/open/floor/facility/dark,
/area/city/backstreets_room)
"b" = (
/obj/structure/sigsystem/connector{
	dir = 8;
	happens_once = 1
	},
/obj/effect/decal/cleanable/blood/gibs/body,
/turf/open/floor/carpet/red,
/area/city/backstreets_room)
"c" = (
/obj/structure/sigsystem/connector,
/turf/open/floor/facility/dark,
/area/city/backstreets_room)
"d" = (
/obj/machinery/door/poddoor/shutters{
	resistance_flags = 64;
	lockpickable = 0
	},
/obj/structure/sigsystem/activator,
/obj/structure/sigsystem/connector{
	dir = 4
	},
/obj/structure/sigsystem/activator,
/turf/open/floor/facility/dark,
/area/city/backstreets_room)
"e" = (
/obj/structure/sigsystem/deployer{
	atom_path = "/mob/living/simple_animal/hostile/ordeal/steel_dawn/steel_noon"
	},
/obj/effect/decal/cleanable/dirt/dust,
/obj/machinery/light/small/red,
/obj/structure/table/reinforced,
/obj/item/dice{
	pixel_y = -6;
	pixel_x = 9
	},
/obj/item/dice/d6/ebony{
	pixel_y = 1;
	pixel_x = -9
	},
/obj/item/storage/pill_bottle/dice{
	pixel_x = 6;
	pixel_y = 5
	},
/turf/open/floor/facility/dark,
/area/city/backstreets_room)
"f" = (
/obj/structure/sigsystem/connector/split{
	dir = 4
	},
/turf/closed/indestructible/syndicate,
/area/city/backstreets_room)
"g" = (
/obj/effect/decal/cleanable/dirt/dust,
/obj/effect/decal/cleanable/blood/gibs/torso{
	dir = 8
	},
/turf/open/floor/facility/dark,
/area/city/backstreets_room)
"i" = (
/obj/effect/decal/cleanable/blood/footprints{
	dir = 4
	},
/obj/effect/decal/cleanable/blood/gibs/limb{
	pixel_y = -6
	},
/turf/open/floor/facility/dark,
/area/city/backstreets_room)
"j" = (
/obj/machinery/door/poddoor/shutters/preopen{
	id = "deathdealer2";
	resistance_flags = 64;
	lockpickable = 0
	},
/obj/structure/sigsystem/connector{
	delay_time = 500
	},
/obj/structure/sigsystem/activator,
/turf/open/floor/facility/dark,
/area/city/backstreets_room)
"k" = (
/obj/structure/sigsystem/pressure_plate{
	dir = 8;
	mobs_only = 1
	},
/obj/effect/decal/cleanable/blood/footprints{
	dir = 4
	},
/turf/open/floor/carpet/red,
/area/city/backstreets_room)
"l" = (
/obj/machinery/door/poddoor/shutters{
	resistance_flags = 64;
	lockpickable = 0
	},
/obj/structure/sigsystem/activator,
/obj/structure/sigsystem/connector,
/turf/open/floor/facility/dark,
/area/city/backstreets_room)
"m" = (
/obj/machinery/door/poddoor/shutters/preopen{
	id = "deathdealer2";
	resistance_flags = 64;
	lockpickable = 0
	},
/obj/structure/sigsystem/connector{
	dir = 4
	},
/obj/structure/sigsystem/activator,
/obj/effect/decal/cleanable/dirt/dust,
/turf/open/floor/facility/dark,
/area/city/backstreets_room)
"n" = (
/obj/machinery/door/poddoor/shutters{
	resistance_flags = 64;
	lockpickable = 0
	},
/obj/structure/sigsystem/connector{
	dir = 4
	},
/obj/structure/sigsystem/activator,
/turf/open/floor/facility/dark,
/area/city/backstreets_room)
"o" = (
/obj/structure/sigsystem/connector,
/obj/effect/decal/cleanable/dirt/dust,
/obj/effect/decal/cleanable/blood/tracks{
	dir = 4
	},
/obj/machinery/light/small/red{
	dir = 1
	},
/turf/open/floor/facility/dark,
/area/city/backstreets_room)
"p" = (
/obj/structure/sigsystem/connector{
	dir = 4
	},
/turf/closed/indestructible/syndicate,
/area/city/backstreets_room)
"r" = (
/obj/machinery/door/poddoor/shutters/preopen{
	id = "deathdealer1";
	resistance_flags = 64;
	lockpickable = 0
	},
/obj/structure/sigsystem/connector{
	dir = 4
	},
/obj/structure/sigsystem/activator,
/turf/open/floor/facility/dark,
/area/city/backstreets_room)
"s" = (
/obj/machinery/door/airlock/grunge,
/turf/open/floor/facility/dark,
/area/city/backstreets_room)
"t" = (
/obj/structure/sigsystem/tower{
	signal_code = 77
	},
/turf/closed/indestructible/syndicate,
/area/city/backstreets_room)
"u" = (
/obj/structure/sigsystem/connector{
	dir = 1
	},
/turf/closed/indestructible/syndicate,
/area/city/backstreets_room)
"w" = (
/obj/structure/table/reinforced,
/obj/structure/sigsystem/connector{
	dir = 1
	},
/obj/effect/decal/cleanable/dirt/dust,
/obj/machinery/light/small/red{
	dir = 1
	},
/turf/open/floor/carpet/red,
/area/city/backstreets_room)
"x" = (
/obj/structure/sigsystem/connector,
/turf/closed/indestructible/syndicate,
/area/city/backstreets_room)
"y" = (
/obj/machinery/door/poddoor/shutters{
	resistance_flags = 64;
	lockpickable = 0
	},
/obj/structure/sigsystem/activator,
/obj/structure/sigsystem/connector{
	dir = 4
	},
/turf/open/floor/facility/dark,
/area/city/backstreets_room)
"z" = (
/obj/structure/sigsystem/tower{
	signal_code = 77;
	dir = 4
	},
/turf/closed/indestructible/syndicate,
/area/city/backstreets_room)
"A" = (
/obj/structure/sigsystem/connector{
	dir = 4
	},
/turf/open/floor/facility/dark,
/area/city/backstreets_room)
"B" = (
/obj/effect/decal/cleanable/dirt/dust,
/obj/effect/decal/cleanable/dirt/dust,
/turf/open/floor/facility/dark,
/area/city/backstreets_room)
"C" = (
/obj/machinery/door/poddoor/shutters/preopen{
	resistance_flags = 64;
	lockpickable = 0
	},
/obj/structure/sigsystem/activator,
/obj/effect/decal/cleanable/blood/tracks{
	dir = 4
	},
/turf/open/floor/facility/dark,
/area/city/backstreets_room)
"D" = (
/obj/effect/decal/cleanable/dirt/dust,
/turf/open/floor/facility/dark,
/area/city/backstreets_room)
"E" = (
/obj/machinery/door/poddoor/shutters{
	resistance_flags = 64;
	lockpickable = 0
	},
/obj/structure/sigsystem/activator,
/obj/structure/sigsystem/activator,
/turf/open/floor/facility/dark,
/area/city/backstreets_room)
"F" = (
/obj/structure/sigsystem/connector{
	dir = 8
	},
/obj/effect/decal/cleanable/blood/footprints{
	dir = 4
	},
/turf/open/floor/carpet/red,
/area/city/backstreets_room)
"G" = (
/obj/effect/decal/cleanable/dirt/dust,
/obj/effect/decal/cleanable/blood/gibs/limb{
	pixel_y = -6;
	dir = 8
	},
/obj/effect/decal/cleanable/blood/old,
/turf/open/floor/carpet/red,
/area/city/backstreets_room)
"H" = (
/obj/structure/sigsystem/connector{
	delay_time = 500
	},
/turf/closed/indestructible/syndicate,
/area/city/backstreets_room)
"I" = (
/turf/open/floor/facility/dark,
/area/city/backstreets_room)
"J" = (
/mob/living/simple_animal/hostile/ordeal/steel_dusk,
/obj/machinery/button/door{
	id = "deathdealer2";
	resistance_flags = 64;
	pixel_y = -26
	},
/turf/open/floor/facility/dark,
/area/city/backstreets_room)
"L" = (
/obj/structure/sigsystem/connector/split{
	dir = 4;
	happens_once = 1
	},
/obj/effect/decal/cleanable/blood/tracks{
	dir = 4
	},
/turf/open/floor/facility/dark,
/area/city/backstreets_room)
"M" = (
/obj/structure/sigsystem/connector,
/obj/effect/decal/cleanable/blood/footprints{
	dir = 4
	},
/turf/open/floor/carpet/red,
/area/city/backstreets_room)
"N" = (
/mob/living/simple_animal/hostile/ordeal/steel_dusk,
/obj/machinery/button/door{
	id = "deathdealer1";
	resistance_flags = 64;
	pixel_y = 23
	},
/turf/open/floor/facility/dark,
/area/city/backstreets_room)
"O" = (
/obj/structure/sigsystem/connector/split,
/turf/closed/indestructible/syndicate,
/area/city/backstreets_room)
"P" = (
/obj/effect/decal/cleanable/blood,
/turf/open/floor/facility/dark,
/area/city/backstreets_room)
"Q" = (
/turf/closed/indestructible/syndicate,
/area/city/backstreets_room)
"S" = (
/obj/structure/sigsystem/pressure_plate{
	dir = 8;
	mobs_only = 1
	},
/obj/effect/decal/cleanable/blood/gibs/old,
/turf/open/floor/carpet/red,
/area/city/backstreets_room)
"T" = (
/obj/structure/sigsystem/connector{
	dir = 4
	},
/obj/effect/decal/cleanable/blood/old,
/turf/open/floor/facility/dark,
/area/city/backstreets_room)
"U" = (
/obj/machinery/door/poddoor/shutters/preopen{
	id = "deathdealer1";
	resistance_flags = 64;
	lockpickable = 0
	},
/obj/structure/sigsystem/connector{
	dir = 4
	},
/obj/structure/sigsystem/activator,
/obj/effect/decal/cleanable/dirt/dust,
/obj/effect/decal/cleanable/blood/gibs/old,
/turf/open/floor/facility/dark,
/area/city/backstreets_room)
"W" = (
/obj/structure/sigsystem/deployer{
	atom_path = "/mob/living/simple_animal/hostile/ordeal/steel_dawn/steel_noon"
	},
/obj/effect/decal/cleanable/dirt/dust,
/obj/structure/table/reinforced,
/obj/item/toy/cards/deck/syndicate,
/turf/open/floor/facility/dark,
/area/city/backstreets_room)
"Y" = (
/obj/structure/table/reinforced,
/obj/item/ego_weapon/ranged/pistol/deathdealer,
/obj/structure/sigsystem/connector/split,
/obj/effect/decal/cleanable/dirt/dust,
/obj/machinery/light/small/red,
/turf/open/floor/carpet/red,
/area/city/backstreets_room)
"Z" = (
/obj/structure/sigsystem/connector{
	dir = 4
	},
/obj/effect/decal/cleanable/dirt/dust,
/obj/effect/decal/cleanable/blood/gibs/up,
/obj/machinery/light/small/red,
/turf/open/floor/facility/dark,
/area/city/backstreets_room)

(1,1,1) = {"
Q
Q
Q
Q
Q
Q
Q
Q
"}
(2,1,1) = {"
Q
p
u
w
Y
p
Q
Q
"}
(3,1,1) = {"
z
O
p
G
F
p
Q
Q
"}
(4,1,1) = {"
Q
a
n
M
b
d
a
Q
"}
(5,1,1) = {"
Q
Q
p
S
k
p
Q
Q
"}
(6,1,1) = {"
Q
a
y
i
g
d
a
Q
"}
(7,1,1) = {"
Q
Q
p
o
Z
p
Q
Q
"}
(8,1,1) = {"
Q
N
l
L
T
E
J
Q
"}
(9,1,1) = {"
Q
t
H
C
p
Q
Q
Q
"}
(10,1,1) = {"
Q
Q
Q
U
u
Q
Q
Q
"}
(11,1,1) = {"
Q
Q
Q
r
Q
Q
Q
Q
"}
(12,1,1) = {"
Q
Q
Q
m
Q
x
p
Q
"}
(13,1,1) = {"
Q
Q
Q
j
x
f
p
Q
"}
(14,1,1) = {"
s
I
D
P
D
A
W
Q
"}
(15,1,1) = {"
Q
D
I
D
B
c
e
Q
"}
(16,1,1) = {"
Q
Q
Q
Q
Q
Q
Q
Q
"}
